111111111111
111111111111
100000000311
161111111111
100000211111
180471111111
101111111111
101111111111
105111111111
100000000911
111111111111
111111111111