--------------
-+--.--.--.---
-.........A..-
-.---.------.-
-.....--.---.-
-.---.--.-----
-.---....-----
-....+.....---
-.-------...--
-.---------.--
-A---.--....--
-.------.--.--
-...........--
--------------