--------------
-0--.--.--.---
-.........A..-
-.---.------.-
-.....--.---.-
-.---.--.-----
-.---....-----
-....1.....---
-.-------...--
-.---------.--
-B---.--....--
-.------.--.--
-...........--
--------------