111111111111
111111111111
111111111311
161111111111
111111211111
181471111111
111111111111
111111111111
115111111111
111111111911
111111111111
111111111111