--------------
-+--.--.--.---
-............-
-.---.--A---.-
-.....--.---.-
-.---.--.-----
-.---....-----
-+....--------
-.-------A..--
-.---------.--
-.------....--
-.------.--.--
-...........--
--------------